1111111111111
10CC00CC000C1
1P0011E000001
1111110010011
1C00000010C11
1111111111111
